111111111111111111111
1P0000C0001110R000C01
10000C00R000000100001
100000111110100001101
111111111111111111101
100000000000000000001
101111111111111111111
1000000111100000000E1
10000000000C0000R0001
111101111111111111111
1C000000000000C000001
111111111111111111111
